.......G..
..2...G..G
G...1..1..
.........2
..W...1...
2.......G.
2.G.......
.1...1..2.
.......1..
..G.....G.