.......G..
..R...G..L
G...R..L..
...R.....R
......L...
R.......G.
R........G
LLW.R...R.
.LGR...LG.
..G.......