.......G..
..R...G..G
G...L..L..
.........R
..W...L...
R.......G.
R.G.......
.L...L..R.
.......L..
..G.....G.